Width: 6
Height: 9

2 2 2 2 2 2
2 3 3 3 3 2
2 3 5 3 9 2
2 2 6 3 3 2
2 3 6 3 2 2
2 3 6 3 2 1
2 3 6 3 2 1
2 3 4 3 2 1
2 2 2 2 2 1