Width: 8
Height: 7

2 2 2 2 2 2 2 2
2 3 3 2 3 3 3 2
2 3 5 4 4 5 3 2
2 9 5 4 6 3 2 2
2 3 5 4 4 5 3 2
2 3 3 2 3 3 3 2
2 2 2 2 2 2 2 2