Width: 8
Height: 8

1 1 2 2 2 1 1 1
1 1 2 4 2 1 1 1
1 1 2 3 2 2 2 2
2 2 2 5 3 5 4 2
2 4 3 5 9 2 2 2
2 2 2 2 5 2 1 1
1 1 1 2 4 2 1 1
1 1 1 2 2 2 1 1